map_tr.png

8 3

10 10

0 0 0 0 4 4 0 0 0 0
0 16 16 16 16 16 16 16 16 0
0 16 16 16 0 0 16 16 16 0
0 16 16 16 0 0 16 16 16 0
0 16 16 16 16 16 16 16 16 0
0 16 16 16 16 16 14 16 16 0
0 16 0 16 16 16 16 16 16 0
0 16 16 16 16 16 16 16 16 0
0 17 16 16 16 16 16 16 16 0
0 0 0 0 0 0 0 0 0 0
