map_sheet.png

8 2

10 10

4 6 6 6 3 3 6 6 6 5
14 3 3 3 3 3 3 3 3 7
14 3 3 3 3 3 3 3 3 7
14 3 2 2 3 3 2 2 3 7
14 3 2 3 3 3 3 2 3 7
14 3 2 2 3 3 2 2 3 7
14 3 3 2 3 3 2 3 3 7
14 3 3 3 3 3 3 3 3 7
14 17 3 3 3 3 3 3 3 7
12 15 15 15 15 15 15 15 15 13
